12x17
#################
#               #
# ### ### ### ###
### # # ### # # #
#       #       #
# ##### # ##### #
#       #       #
### # # # # # ###
#       #       #
# ############# #
#       #       #
#################
1,8
10,7
10,9